0000000000000000000000000000
0000002000000222000000000000
0000000100010101010000000000
0000200010000000000000100000
1111000010110001000000000000
0000000010000000000000000000
0000002010000000000000000001
0000000010000020000000000000
0000001000000000100000000002
0220000000002000000000200000
2000000000000010001001000000
0000000000000000000000000000
0000000000000000000000000000
0300010040000002000010000020
0000000000000000000000000000
0000000000000000000000000000